9,2,2,2,2,2,2,2,2,2
9,2,0,0,0,0,0,0,0,2
9,2,0,0,1,0,0,0,0,2
2,0,0,0,3,0,0,0,0,2
2,0,0,0,4,0,6,0,0,2
9,2,0,0,0,0,0,0,0,2
2,0,0,0,0,0,0,0,0,2
2,2,2,0,0,0,0,0,0,2
9,9,2,0,0,0,0,0,0,2
9,2,2,2,2,2,2,2,2,2